{
    "gridWidth": 25,
    "gridHeight": 25,
    "gridSize": 1.0,
    "Levels": [
        {
            "levelName": "LEVEL1",
            "levelNumber": 1,
            "MinMoveCounter": 0,
            "threeStar": 10,
            "twoStar": 15,
            "uneStar": 20,
            "layoutData": [
                0,0,0,0,0,0,0,0,0,0,0,0,0,0,0,0,0,0,0,0,0,0,0,0,0,
                0,0,0,0,0,0,0,0,0,4,0,6,0,0,0,0,0,0,0,0,0,0,0,0,0,
                0,0,0,0,0,0,0,0,0,4,2,6,0,0,0,0,0,0,0,0,0,0,0,0,0,
                0,0,0,0,0,0,0,0,0,4,0,6,0,0,0,0,0,0,0,0,0,0,0,0,0,
                0,3,3,3,3,3,4,3,3,0,0,0,0,0,0,0,0,0,0,0,0,0,0,0,0,
                0,3,3,3,3,3,4,3,6,6,6,6,6,6,6,6,0,0,0,0,0,0,0,0,0,
                0,3,3,3,3,3,4,3,6,0,0,0,0,0,0,0,0,0,0,0,0,0,0,0,0,
                0,0,2,2,3,3,3,3,6,0,0,0,0,0,0,0,0,0,0,0,0,0,0,0,0,
                0,0,3,3,3,3,3,3,0,0,0,0,0,0,0,0,0,0,0,0,0,0,0,0,0,
                0,0,3,3,3,3,3,3,0,0,0,0,0,0,0,0,0,0,0,0,0,0,0,0,0,
                0,0,3,3,2,0,4,0,6,0,0,0,0,0,0,0,0,0,0,0,0,0,4,4,4,
                0,0,3,3,3,0,4,2,6,6,6,6,0,0,0,0,0,0,0,0,0,5,4,4,4,
                0,0,3,3,3,3,4,0,0,0,0,6,0,0,0,0,0,0,0,0,0,0,4,4,4,
                0,3,3,3,3,3,3,0,0,0,0,6,0,0,0,0,0,0,0,0,0,0,4,4,4,
                0,3,3,3,0,0,0,0,0,0,0,0,6,0,0,0,0,0,0,4,0,0,0,0,4,
                0,3,3,3,0,0,0,0,0,0,0,0,6,0,0,0,0,0,0,4,0,0,0,0,4,
                0,3,0,0,0,0,0,0,0,0,0,6,0,0,0,0,0,0,0,4,0,0,0,0,4,
                0,3,0,0,0,0,0,0,0,0,0,6,0,4,4,4,4,0,0,4,0,0,0,0,4,
                0,6,6,6,6,0,0,0,0,0,6,0,0,0,2,4,0,0,0,4,0,0,0,0,4,
                0,0,0,0,0,0,0,0,0,0,6,0,0,0,0,4,0,0,0,4,0,0,0,0,4,
                0,0,0,0,0,0,0,0,0,0,6,0,0,0,0,4,0,0,0,4,0,0,0,0,4,
                7,0,0,0,0,0,0,0,0,0,6,0,0,0,0,0,0,0,0,0,0,0,0,0,4,
                7,0,0,0,0,0,0,0,0,0,6,0,0,0,0,0,0,0,0,0,0,0,0,0,4,
                0,0,0,0,0,0,0,0,0,0,6,0,0,0,0,0,0,0,0,0,0,0,0,0,4,
                0,0,0,0,0,0,0,0,0,0,6,0,0,0,0,0,1,0,0,0,0,0,0,0,4
            ],
            "data": [
                { "id": 0, "blockName": "floor", "isCharacter": false },
                { "id": 1, "blockName": "character", "isCharacter": true },
                { "id": 2, "blockName": "movableBlock", "isCharacter": false },
                { "id": 3, "blockName": "iceFloor", "isCharacter": false },
                { "id": 4, "blockName": "wall", "isCharacter": false },
                { "id": 5, "blockName": "turret", "isCharacter": false },
                { "id": 6, "blockName": "heavyRock", "isCharacter": false },
                { "id": 7, "blockName": "exit", "isCharacter": false }
            ]
        },


        {
            "levelName": "LEVEL2",
            "levelNumber": 1,
            "MinMoveCounter": 0,
            "threeStar": 10,
            "twoStar": 15,
            "uneStar": 20,
            "layoutData": [
                0,0,0,0,0,0,0,0,0,0,0,0,0,0,0,0,0,0,0,0,0,0,0,0,0,
                0,0,0,0,0,0,0,0,0,0,0,0,0,0,0,0,0,0,0,0,0,0,0,0,0,
                0,0,0,0,0,0,0,0,0,0,0,0,0,0,0,0,0,0,0,0,0,0,0,0,0,
                0,0,0,0,0,0,0,0,0,0,0,0,0,0,0,0,0,0,0,0,0,0,0,0,0,
                0,0,0,0,0,0,0,0,0,0,0,0,0,0,0,0,0,0,0,0,0,0,0,0,0,
                0,0,0,0,0,0,0,0,0,0,0,0,0,0,0,0,0,0,0,0,0,0,0,0,0,
                0,0,0,0,0,0,0,0,0,0,0,0,0,0,0,0,0,0,0,0,0,0,0,0,0,
                0,0,0,0,0,0,0,0,0,0,0,0,0,0,0,0,0,0,0,0,0,0,0,0,0,
                0,0,0,0,0,0,0,0,0,0,0,0,0,0,0,0,0,0,0,0,0,0,0,0,0,
                0,0,0,0,0,0,0,0,0,0,0,0,0,0,0,0,0,0,0,0,0,0,0,0,0,
                0,0,0,0,0,0,0,0,0,0,0,0,0,0,0,0,0,0,0,0,0,0,0,0,0,
                0,0,0,0,0,0,0,0,0,0,0,0,0,0,0,0,0,0,0,0,0,0,0,0,0,
                0,0,0,0,0,0,0,0,0,0,0,0,0,0,0,0,0,0,0,0,0,0,0,0,0,
                0,0,0,0,0,0,0,0,0,0,0,0,0,0,0,0,0,0,0,0,0,0,0,0,0,
                0,0,0,0,0,0,0,0,0,0,0,0,0,0,0,0,0,0,0,0,0,0,0,0,0,
                0,0,0,0,0,0,0,0,0,0,0,0,0,0,0,0,0,0,0,0,0,0,0,0,0,
                0,0,0,0,0,0,0,0,0,0,0,0,0,0,0,0,0,0,0,0,0,0,0,0,0,
                0,0,0,0,0,0,0,0,0,0,0,0,0,0,0,0,0,0,0,0,0,0,0,0,0,
                0,0,0,0,0,0,0,0,0,0,0,0,0,0,0,0,0,0,0,0,0,0,0,0,0,
                0,0,0,0,0,0,0,0,0,0,0,0,0,0,0,0,0,0,0,0,0,0,0,0,0,
                0,0,0,0,0,0,4,4,4,4,0,0,0,0,0,0,0,0,0,0,0,0,0,0,0,
                0,0,0,0,0,0,0,0,0,0,0,0,0,0,0,0,0,0,0,0,0,0,0,0,0,
                0,0,0,0,0,0,1,0,0,0,0,0,0,0,0,0,0,0,0,0,0,0,0,0,0,
                0,0,0,0,0,0,0,0,0,0,0,0,0,0,0,0,0,0,0,0,0,0,0,0,0,
                0,0,0,0,0,0,0,0,0,0,0,0,0,0,0,0,0,0,0,0,0,0,0,0,0
            ],
            "data": [
                { "id": 0, "blockName": "floor", "isCharacter": false },
                { "id": 1, "blockName": "character", "isCharacter": true },
                { "id": 2, "blockName": "movableBlock", "isCharacter": false },
                { "id": 3, "blockName": "iceFloor", "isCharacter": false },
                { "id": 4, "blockName": "wall", "isCharacter": false },
                { "id": 5, "blockName": "turret", "isCharacter": false },
                { "id": 6, "blockName": "heavy rock", "isCharacter": false }
            ]
        }

    ]
}